1111111111111111111111
1000100000000001000001
1000100000000001000001
1000000010000001000001
1000000010000000000001
1000000010000000000001
1111111111111111111111
