111111111111111111111
100000001000000000001
10P000001000000000001
100000001000000000001
100000000000000100E01
10000C000000000100001
111111111111111111111
