111111111111111111111
100100000000000100001
100100000000000100001
100100000100000100001
100000000100000000001
10000000010000000E001
111111111111111111111
