11111111111111111
100P1000C00000001
10001000000000001
10001000000011111
10000000000000001
10000000100000001
10000000100010E01
11111111111111111
