11111111111111111
10001000C00000001
10001000000000001
10001000000011111
100P0000000000001
1000100010C000001
10000C010C0010E01
11111111111111111
