1111111111111111111111
100P00000001000000C001
10000000C0010C00000001
1111110000010000000001
1000000000000001000C01
10000C00000C0001000001
1000000000C000010E0001
1111111111111111111111
