11111111111111111
100P1000C00000001
10001000000000001
1000100C000011111
1000000000000C001
100C0000100000001
10000000100010E01
11111111111111111
