11111111111111111111
10000000000100000001
111111000C0100000001
1000C000000000000001
100000000C000P000001
100000000C0000000001
1000C00000000000E001
11111111111111111111
