1111111111111111
1000000100000001
111111000C000001
1000C00000000001
1000C00000000001
1000100000000001
10C0100000000001
10C0100000000001
1000100000000001
10000C000P000001
10000C0000000001
1000C0000000E001
1111111111111111
