11111111111111111111
10000000000100000001
11111100000100000001
10000000000000000001
100000000000000P0001
10000000000000000001
10000000000000000E01
11111111111111111111
