1111111111
1000000001
1000000001
111000P001
1010000001
1011100001
1000100C01
10E0100001
100000C001
1111111111
